27,26,25,24,23, 0, 0,22,21,20,19, 0, 0,18,17,16,15,14,13,12
28, 0, 0, 0, 0, 0, 0, 0, 0, 0, 0, 0, 0, 0, 0, 0, 0, 0, 0,11
29, 0,57,56,55, 0, 0,50,49,48,47, 0, 0,41,40,39,38,37, 0,10
30, 0,58,59,60, 0, 0,51,52,53,54, 0, 0,42,43,44,45,46, 0, 9
31, 0, 0, 0, 0, 0, 0, 0, 0, 0, 0, 0, 0, 0, 0, 0, 0, 0, 0, 8
32,33,34,35,36, 0, 0, 0, 0, 0, 0, 0, 0, 1, 2, 3, 4, 5, 6, 7
